10
#S########
#..#.#.#.#
##.#.....#
##...#####
#..#..#..#
#.###.#.##
#........#
#.##.##.##
#.....#..#
########G#
