32
################################
S.......#.###..#.......#..#..#.#
######..#..#...#...#...##.#....#
#....#..#....###...##...#.#.####
#..#.#..#..#...###..#...#.#....#
##.#.#..#..#...#....###.#.#.##.#
##.#....#..#.###....##..#.#..#.#
#..#....#..#...#..#..#..#......#
#..........#.#....#..#..#..#.###
#######..#.#.#....#..##.#..#...#
#........#.#...#..#...#.#.##.#.#
#...#.#..#.##..##.##..#.#.#..#.#
#..##.#..#.#....#..#..#.#.#.##.#
#.##..#.##.#....#..#..#.#......G
###...#.#..#.#..#..#.##.#.###.##
##..#.####.#.#..##.#..#.#......#
#..##....#.#.#...#....#.#.#.####
#.##...#.#.#.#...##.......#....#
###....#.....#............#..###
##..#..##..###..#...########...#
#..##..#.....#..###..........###
#####..#.#..##....##############
#......######..##.........#.#..#
###...##........########.##.#..#
#...###...........#......#..#.##
#.###...######..#.######....#.##
###....##.......#..#.##..#.##.##
#.....##..#######..#.#..##....##
#...###.........#..#.#..#..#####
#.###....########..#.#.##.....##
###.............#....#.#..###.##
################################
